kernel,inst_line,inst_text,Masked,SDC,DUE,tot_inj,valid_rate,SDC_rate
stencil_1d,28,"ld.param.u64 %rd3, [_Z10stencil_1dPKiPii_param_0];",1284,220,0,1504,0.030694,0.146277
stencil_1d,29,"ld.param.u64 %rd4, [_Z10stencil_1dPKiPii_param_1];",990,596,0,1586,0.032367,0.375788
stencil_1d,30,"ld.param.u32 %r6, [_Z10stencil_1dPKiPii_param_2];",1557,15,0,1572,0.032082,0.009542
stencil_1d,31,"mov.u32 %r7, %ntid.x;",1496,0,0,1496,0.030531,0.000000
stencil_1d,32,"mov.u32 %r8, %ctaid.x;",1473,6,0,1479,0.030184,0.004057
stencil_1d,33,"mov.u32 %r1, %tid.x;",1137,270,0,1407,0.028714,0.191898
stencil_1d,34,"mad.lo.s32 %r2, %r7, %r8, %r1;",1300,283,0,1583,0.032306,0.178774
stencil_1d,35,"setp.ge.s32%p1, %r2, %r6;",954,0,0,954,0.019469,0.000000
stencil_1d,38,"cvta.to.global.u64 %rd5, %rd3;",976,7,0,983,0.020061,0.007121
stencil_1d,39,"mul.wide.s32 %rd6, %r2, 4;",0,1163,0,1163,0.023735,1.000000
stencil_1d,40,"add.s64 %rd1, %rd5, %rd6;",1022,17,0,1039,0.021204,0.016362
stencil_1d,41,"ld.global.nc.u32 %r9, [%rd1];",628,262,0,890,0.018163,0.294382
stencil_1d,42,"shl.b32 %r10, %r1, 2;",935,6,0,941,0.019204,0.006376
stencil_1d,43,"mov.u32 %r11, _ZZ10stencil_1dPKiPiiE4temp;",918,4,0,922,0.018816,0.004338
stencil_1d,44,"add.s32 %r3, %r11, %r10;",183,731,0,914,0.018653,0.799781
stencil_1d,46,"setp.gt.u32%p2, %r1, 6;",737,0,0,737,0.015041,0.000000
stencil_1d,49,"setp.lt.s32%p3, %r2, 7;",14,0,0,14,0.000286,0.000000
stencil_1d,50,"mov.u32 %r44, 0;",28,0,0,28,0.000571,0.000000
stencil_1d,57,"add.s32 %r13, %r2, 249;",22,0,0,22,0.000449,0.000000
stencil_1d,58,"setp.ge.s32%p4, %r13, %r6;",13,0,0,13,0.000265,0.000000
stencil_1d,61,"ld.global.nc.u32 %r14, [%rd1+1024];",15,9,0,24,0.000490,0.375000
stencil_1d,65,"cvta.to.global.u64 %rd2, %rd4;",0,924,0,924,0.018857,1.000000
stencil_1d,67,"ld.shared.u32 %r15, [%r3+4];",406,272,0,678,0.013837,0.401180
stencil_1d,68,"ld.shared.u32 %r16, [%r3];",446,247,0,693,0.014143,0.356421
stencil_1d,69,"add.s32 %r17, %r15, %r16;",379,33,0,412,0.008408,0.080097
stencil_1d,70,"ld.shared.u32 %r18, [%r3+8];",242,18,0,260,0.005306,0.069231
stencil_1d,71,"add.s32 %r19, %r18, %r17;",347,15,0,362,0.007388,0.041436
stencil_1d,72,"ld.shared.u32 %r20, [%r3+12];",497,20,0,517,0.010551,0.038685
stencil_1d,73,"add.s32 %r21, %r20, %r19;",455,21,0,476,0.009714,0.044118
stencil_1d,74,"ld.shared.u32 %r22, [%r3+16];",217,15,0,232,0.004735,0.064655
stencil_1d,75,"add.s32 %r23, %r22, %r21;",388,21,0,409,0.008347,0.051345
stencil_1d,76,"ld.shared.u32 %r24, [%r3+20];",322,21,0,343,0.007000,0.061224
stencil_1d,77,"add.s32 %r25, %r24, %r23;",133,27,0,160,0.003265,0.168750
stencil_1d,78,"ld.shared.u32 %r26, [%r3+24];",294,24,0,318,0.006490,0.075472
stencil_1d,79,"add.s32 %r27, %r26, %r25;",277,22,0,299,0.006102,0.073579
stencil_1d,80,"ld.shared.u32 %r28, [%r3+28];",282,24,0,306,0.006245,0.078431
stencil_1d,81,"add.s32 %r29, %r28, %r27;",281,15,0,296,0.006041,0.050676
stencil_1d,82,"ld.shared.u32 %r30, [%r3+32];",265,32,0,297,0.006061,0.107744
stencil_1d,83,"add.s32 %r31, %r30, %r29;",6,265,0,271,0.005531,0.977860
stencil_1d,84,"ld.shared.u32 %r32, [%r3+36];",3,228,0,231,0.004714,0.987013
stencil_1d,85,"add.s32 %r33, %r32, %r31;",4,1,0,5,0.000102,0.200000
stencil_1d,86,"ld.shared.u32 %r34, [%r3+40];",96,18,0,114,0.002327,0.157895
stencil_1d,87,"add.s32 %r35, %r34, %r33;",76,43,0,119,0.002429,0.361345
stencil_1d,88,"ld.shared.u32 %r36, [%r3+44];",89,17,0,106,0.002163,0.160377
stencil_1d,89,"add.s32 %r37, %r36, %r35;",61,21,0,82,0.001673,0.256098
stencil_1d,90,"ld.shared.u32 %r38, [%r3+48];",60,25,0,85,0.001735,0.294118
stencil_1d,91,"add.s32 %r39, %r38, %r37;",40,20,0,60,0.001224,0.333333
stencil_1d,92,"ld.shared.u32 %r40, [%r3+52];",34,30,0,64,0.001306,0.468750
stencil_1d,93,"add.s32 %r41, %r40, %r39;",15,19,0,34,0.000694,0.558824
stencil_1d,94,"ld.shared.u32 %r42, [%r3+56];",12,30,0,42,0.000857,0.714286
stencil_1d,95,"add.s32 %r43, %r42, %r41;",3,9,0,12,0.000245,0.750000
stencil_1d,96,"add.s64 %rd8, %rd2, %rd6;",1,9,0,10,0.000204,0.900000
invalid_summary,,,21512,0,0,21512,0.439020,0.000000
