kernel,inst_line,inst_text,Masked,SDC,DUE,tot_inj,valid_rate,SDC_rate
stencil_1d,28,"ld.param.u64 %rd3, [_Z10stencil_1dPKiPii_param_0];",3488,0,0,3488,0.032296,0.000000
stencil_1d,29,"ld.param.u64 %rd4, [_Z10stencil_1dPKiPii_param_1];",3472,0,0,3472,0.032148,0.000000
stencil_1d,30,"ld.param.u32 %r6, [_Z10stencil_1dPKiPii_param_2];",3300,0,0,3300,0.030556,0.000000
stencil_1d,31,"mov.u32 %r7, %ntid.x;",3381,0,0,3381,0.031306,0.000000
stencil_1d,32,"mov.u32 %r8, %ctaid.x;",3378,0,0,3378,0.031278,0.000000
stencil_1d,33,"mov.u32 %r1, %tid.x;",3231,17,0,3248,0.030074,0.005234
stencil_1d,34,"mad.lo.s32 %r2, %r7, %r8, %r1;",3524,5,0,3529,0.032676,0.001417
stencil_1d,35,"setp.ge.s32%p1, %r2, %r6;",2069,0,0,2069,0.019157,0.000000
stencil_1d,38,"cvta.to.global.u64 %rd5, %rd3;",2269,0,0,2269,0.021009,0.000000
stencil_1d,39,"mul.wide.s32 %rd6, %r2, 4;",2697,0,0,2697,0.024972,0.000000
stencil_1d,40,"add.s64 %rd1, %rd5, %rd6;",2183,0,0,2183,0.020213,0.000000
stencil_1d,41,"ld.global.nc.u32 %r9, [%rd1];",1514,603,0,2117,0.019602,0.284837
stencil_1d,42,"shl.b32 %r10, %r1, 2;",2085,0,0,2085,0.019306,0.000000
stencil_1d,43,"mov.u32 %r11, _ZZ10stencil_1dPKiPiiE4temp;",2047,0,0,2047,0.018954,0.000000
stencil_1d,44,"add.s32 %r3, %r11, %r10;",2007,8,0,2015,0.018657,0.003970
stencil_1d,46,"setp.gt.u32%p2, %r1, 6;",1576,0,0,1576,0.014593,0.000000
stencil_1d,49,"setp.lt.s32%p3, %r2, 7;",37,0,0,37,0.000343,0.000000
stencil_1d,50,"mov.u32 %r44, 0;",55,0,0,55,0.000509,0.000000
stencil_1d,57,"add.s32 %r13, %r2, 249;",28,0,0,28,0.000259,0.000000
stencil_1d,58,"setp.ge.s32%p4, %r13, %r6;",38,0,0,38,0.000352,0.000000
stencil_1d,61,"ld.global.nc.u32 %r14, [%rd1+1024];",23,9,0,32,0.000296,0.281250
stencil_1d,65,"cvta.to.global.u64 %rd2, %rd4;",1917,0,0,1917,0.017750,0.000000
stencil_1d,67,"ld.shared.u32 %r15, [%r3+4];",936,559,0,1495,0.013843,0.373913
stencil_1d,68,"ld.shared.u32 %r16, [%r3];",890,588,0,1478,0.013685,0.397835
stencil_1d,69,"add.s32 %r17, %r15, %r16;",864,49,0,913,0.008454,0.053669
stencil_1d,70,"ld.shared.u32 %r18, [%r3+8];",522,45,0,567,0.005250,0.079365
stencil_1d,71,"add.s32 %r19, %r18, %r17;",769,44,0,813,0.007528,0.054121
stencil_1d,72,"ld.shared.u32 %r20, [%r3+12];",1050,42,0,1092,0.010111,0.038462
stencil_1d,73,"add.s32 %r21, %r20, %r19;",1065,51,0,1116,0.010333,0.045699
stencil_1d,74,"ld.shared.u32 %r22, [%r3+16];",499,40,0,539,0.004991,0.074212
stencil_1d,75,"add.s32 %r23, %r22, %r21;",814,65,0,879,0.008139,0.073948
stencil_1d,76,"ld.shared.u32 %r24, [%r3+20];",737,48,0,785,0.007269,0.061146
stencil_1d,77,"add.s32 %r25, %r24, %r23;",262,47,0,309,0.002861,0.152104
stencil_1d,78,"ld.shared.u32 %r26, [%r3+24];",659,48,0,707,0.006546,0.067893
stencil_1d,79,"add.s32 %r27, %r26, %r25;",611,41,0,652,0.006037,0.062883
stencil_1d,80,"ld.shared.u32 %r28, [%r3+28];",620,53,0,673,0.006231,0.078752
stencil_1d,81,"add.s32 %r29, %r28, %r27;",540,43,0,583,0.005398,0.073756
stencil_1d,82,"ld.shared.u32 %r30, [%r3+32];",564,48,0,612,0.005667,0.078431
stencil_1d,83,"add.s32 %r31, %r30, %r29;",10,597,0,607,0.005620,0.983526
stencil_1d,84,"ld.shared.u32 %r32, [%r3+36];",8,570,0,578,0.005352,0.986159
stencil_1d,85,"add.s32 %r33, %r32, %r31;",6,3,0,9,0.000083,0.333333
stencil_1d,86,"ld.shared.u32 %r34, [%r3+40];",199,48,0,247,0.002287,0.194332
stencil_1d,87,"add.s32 %r35, %r34, %r33;",192,62,0,254,0.002352,0.244094
stencil_1d,88,"ld.shared.u32 %r36, [%r3+44];",168,63,0,231,0.002139,0.272727
stencil_1d,89,"add.s32 %r37, %r36, %r35;",115,49,0,164,0.001519,0.298780
stencil_1d,90,"ld.shared.u32 %r38, [%r3+48];",133,45,0,178,0.001648,0.252809
stencil_1d,91,"add.s32 %r39, %r38, %r37;",83,53,0,136,0.001259,0.389706
stencil_1d,92,"ld.shared.u32 %r40, [%r3+52];",84,48,0,132,0.001222,0.363636
stencil_1d,93,"add.s32 %r41, %r40, %r39;",42,43,0,85,0.000787,0.505882
stencil_1d,94,"ld.shared.u32 %r42, [%r3+56];",25,58,0,83,0.000769,0.698795
stencil_1d,95,"add.s32 %r43, %r42, %r41;",5,25,0,30,0.000278,0.833333
stencil_1d,96,"add.s64 %rd8, %rd2, %rd6;",29,0,0,29,0.000269,0.000000
invalid_summary,,,47063,0,0,47063,0.435769,0.000000
