kernel,inst_line,inst_text,Masked,SDC,DUE,tot_inj,valid_rate,SDC_rate
stencil_1d,28,"ld.param.u64 %rd3, [_Z10stencil_1dPKiPii_param_0];",1645,384,0,2029,0.031703,0.189256
stencil_1d,29,"ld.param.u64 %rd4, [_Z10stencil_1dPKiPii_param_1];",1299,755,0,2054,0.032094,0.367575
stencil_1d,30,"ld.param.u32 %r6, [_Z10stencil_1dPKiPii_param_2];",1980,17,0,1997,0.031203,0.008513
stencil_1d,31,"mov.u32 %r7, %ntid.x;",1944,0,0,1944,0.030375,0.000000
stencil_1d,32,"mov.u32 %r8, %ctaid.x;",1963,11,0,1974,0.030844,0.005572
stencil_1d,33,"mov.u32 %r1, %tid.x;",1483,390,0,1873,0.029266,0.208222
stencil_1d,34,"mad.lo.s32 %r2, %r7, %r8, %r1;",1677,378,0,2055,0.032109,0.183942
stencil_1d,35,"setp.ge.s32%p1, %r2, %r6;",1235,1,0,1236,0.019312,0.000809
stencil_1d,38,"cvta.to.global.u64 %rd5, %rd3;",1366,13,0,1379,0.021547,0.009427
stencil_1d,39,"mul.wide.s32 %rd6, %r2, 4;",0,1608,0,1608,0.025125,1.000000
stencil_1d,40,"add.s64 %rd1, %rd5, %rd6;",1318,21,0,1339,0.020922,0.015683
stencil_1d,41,"ld.global.nc.u32 %r9, [%rd1];",969,345,0,1314,0.020531,0.262557
stencil_1d,42,"shl.b32 %r10, %r1, 2;",1239,8,0,1247,0.019484,0.006415
stencil_1d,43,"mov.u32 %r11, _ZZ10stencil_1dPKiPiiE4temp;",1195,7,0,1202,0.018781,0.005824
stencil_1d,44,"add.s32 %r3, %r11, %r10;",54,1112,0,1166,0.018219,0.953688
stencil_1d,46,"setp.gt.u32%p2, %r1, 6;",928,0,0,928,0.014500,0.000000
stencil_1d,49,"setp.lt.s32%p3, %r2, 7;",26,0,0,26,0.000406,0.000000
stencil_1d,50,"mov.u32 %r44, 0;",30,0,0,30,0.000469,0.000000
stencil_1d,57,"add.s32 %r13, %r2, 249;",25,0,0,25,0.000391,0.000000
stencil_1d,58,"setp.ge.s32%p4, %r13, %r6;",18,0,0,18,0.000281,0.000000
stencil_1d,61,"ld.global.nc.u32 %r14, [%rd1+1024];",10,10,0,20,0.000313,0.500000
stencil_1d,65,"cvta.to.global.u64 %rd2, %rd4;",0,1087,0,1087,0.016984,1.000000
stencil_1d,67,"ld.shared.u32 %r15, [%r3+4];",506,297,0,803,0.012547,0.369863
stencil_1d,68,"ld.shared.u32 %r16, [%r3];",546,326,0,872,0.013625,0.373853
stencil_1d,69,"add.s32 %r17, %r15, %r16;",511,27,0,538,0.008406,0.050186
stencil_1d,70,"ld.shared.u32 %r18, [%r3+8];",339,35,0,374,0.005844,0.093583
stencil_1d,71,"add.s32 %r19, %r18, %r17;",521,31,0,552,0.008625,0.056159
stencil_1d,72,"ld.shared.u32 %r20, [%r3+12];",617,35,0,652,0.010188,0.053681
stencil_1d,73,"add.s32 %r21, %r20, %r19;",623,25,0,648,0.010125,0.038580
stencil_1d,74,"ld.shared.u32 %r22, [%r3+16];",259,36,0,295,0.004609,0.122034
stencil_1d,75,"add.s32 %r23, %r22, %r21;",425,18,0,443,0.006922,0.040632
stencil_1d,76,"ld.shared.u32 %r24, [%r3+20];",391,33,0,424,0.006625,0.077830
stencil_1d,77,"add.s32 %r25, %r24, %r23;",180,27,0,207,0.003234,0.130435
stencil_1d,78,"ld.shared.u32 %r26, [%r3+24];",397,40,0,437,0.006828,0.091533
stencil_1d,79,"add.s32 %r27, %r26, %r25;",344,26,0,370,0.005781,0.070270
stencil_1d,80,"ld.shared.u32 %r28, [%r3+28];",390,32,0,422,0.006594,0.075829
stencil_1d,81,"add.s32 %r29, %r28, %r27;",327,36,0,363,0.005672,0.099174
stencil_1d,82,"ld.shared.u32 %r30, [%r3+32];",352,38,0,390,0.006094,0.097436
stencil_1d,83,"add.s32 %r31, %r30, %r29;",8,352,0,360,0.005625,0.977778
stencil_1d,84,"ld.shared.u32 %r32, [%r3+36];",9,386,0,395,0.006172,0.977215
stencil_1d,85,"add.s32 %r33, %r32, %r31;",2,1,0,3,0.000047,0.333333
stencil_1d,86,"ld.shared.u32 %r34, [%r3+40];",140,25,0,165,0.002578,0.151515
stencil_1d,87,"add.s32 %r35, %r34, %r33;",117,24,0,141,0.002203,0.170213
stencil_1d,88,"ld.shared.u32 %r36, [%r3+44];",80,17,0,97,0.001516,0.175258
stencil_1d,89,"add.s32 %r37, %r36, %r35;",82,23,0,105,0.001641,0.219048
stencil_1d,90,"ld.shared.u32 %r38, [%r3+48];",67,35,0,102,0.001594,0.343137
stencil_1d,91,"add.s32 %r39, %r38, %r37;",47,29,0,76,0.001187,0.381579
stencil_1d,92,"ld.shared.u32 %r40, [%r3+52];",24,35,0,59,0.000922,0.593220
stencil_1d,93,"add.s32 %r41, %r40, %r39;",13,35,0,48,0.000750,0.729167
stencil_1d,94,"ld.shared.u32 %r42, [%r3+56];",10,30,0,40,0.000625,0.750000
stencil_1d,95,"add.s32 %r43, %r42, %r41;",3,12,0,15,0.000234,0.800000
stencil_1d,96,"add.s64 %rd8, %rd2, %rd6;",1,15,0,16,0.000250,0.937500
invalid_summary,,,28037,0,0,28037,0.438078,0.000000
