kernel,inst_line,inst_text,Masked,SDC,DUE,tot_inj,valid_rate,SDC_rate
stencil_1d,28,"ld.param.u64 %rd3, [_Z10stencil_1dPKiPii_param_0];",4308,905,0,5213,0.032379,0.173604
stencil_1d,29,"ld.param.u64 %rd4, [_Z10stencil_1dPKiPii_param_1];",3251,1956,0,5207,0.032342,0.375648
stencil_1d,30,"ld.param.u32 %r6, [_Z10stencil_1dPKiPii_param_2];",5030,61,0,5091,0.031621,0.011982
stencil_1d,31,"mov.u32 %r7, %ntid.x;",5079,0,0,5079,0.031547,0.000000
stencil_1d,32,"mov.u32 %r8, %ctaid.x;",4939,29,0,4968,0.030857,0.005837
stencil_1d,33,"mov.u32 %r1, %tid.x;",3942,912,0,4854,0.030149,0.187886
stencil_1d,34,"mad.lo.s32 %r2, %r7, %r8, %r1;",4278,896,0,5174,0.032137,0.173174
stencil_1d,35,"setp.ge.s32%p1, %r2, %r6;",3076,0,0,3076,0.019106,0.000000
stencil_1d,38,"cvta.to.global.u64 %rd5, %rd3;",3355,39,0,3394,0.021081,0.011491
stencil_1d,39,"mul.wide.s32 %rd6, %r2, 4;",0,4085,0,4085,0.025373,1.000000
stencil_1d,40,"add.s64 %rd1, %rd5, %rd6;",3255,41,0,3296,0.020472,0.012439
stencil_1d,41,"ld.global.nc.u32 %r9, [%rd1];",2235,905,0,3140,0.019503,0.288217
stencil_1d,42,"shl.b32 %r10, %r1, 2;",3192,18,0,3210,0.019938,0.005607
stencil_1d,43,"mov.u32 %r11, _ZZ10stencil_1dPKiPiiE4temp;",3091,20,0,3111,0.019323,0.006429
stencil_1d,44,"add.s32 %r3, %r11, %r10;",120,2950,0,3070,0.019068,0.960912
stencil_1d,46,"setp.gt.u32%p2, %r1, 6;",2444,0,0,2444,0.015180,0.000000
stencil_1d,49,"setp.lt.s32%p3, %r2, 7;",61,0,0,61,0.000379,0.000000
stencil_1d,50,"mov.u32 %r44, 0;",77,0,0,77,0.000478,0.000000
stencil_1d,57,"add.s32 %r13, %r2, 249;",63,0,0,63,0.000391,0.000000
stencil_1d,58,"setp.ge.s32%p4, %r13, %r6;",55,0,0,55,0.000342,0.000000
stencil_1d,61,"ld.global.nc.u32 %r14, [%rd1+1024];",33,19,0,52,0.000323,0.365385
stencil_1d,65,"cvta.to.global.u64 %rd2, %rd4;",0,2878,0,2878,0.017876,1.000000
stencil_1d,67,"ld.shared.u32 %r15, [%r3+4];",1358,832,0,2190,0.013602,0.379909
stencil_1d,68,"ld.shared.u32 %r16, [%r3];",1347,865,0,2212,0.013739,0.391049
stencil_1d,69,"add.s32 %r17, %r15, %r16;",1240,97,0,1337,0.008304,0.072550
stencil_1d,70,"ld.shared.u32 %r18, [%r3+8];",829,68,0,897,0.005571,0.075808
stencil_1d,71,"add.s32 %r19, %r18, %r17;",1246,59,0,1305,0.008106,0.045211
stencil_1d,72,"ld.shared.u32 %r20, [%r3+12];",1486,78,0,1564,0.009714,0.049872
stencil_1d,73,"add.s32 %r21, %r20, %r19;",1493,72,0,1565,0.009720,0.046006
stencil_1d,74,"ld.shared.u32 %r22, [%r3+16];",781,63,0,844,0.005242,0.074645
stencil_1d,75,"add.s32 %r23, %r22, %r21;",1098,97,0,1195,0.007422,0.081172
stencil_1d,76,"ld.shared.u32 %r24, [%r3+20];",1097,73,0,1170,0.007267,0.062393
stencil_1d,77,"add.s32 %r25, %r24, %r23;",453,75,0,528,0.003280,0.142045
stencil_1d,78,"ld.shared.u32 %r26, [%r3+24];",968,59,0,1027,0.006379,0.057449
stencil_1d,79,"add.s32 %r27, %r26, %r25;",918,69,0,987,0.006130,0.069909
stencil_1d,80,"ld.shared.u32 %r28, [%r3+28];",938,79,0,1017,0.006317,0.077679
stencil_1d,81,"add.s32 %r29, %r28, %r27;",892,74,0,966,0.006000,0.076605
stencil_1d,82,"ld.shared.u32 %r30, [%r3+32];",911,65,0,976,0.006062,0.066598
stencil_1d,83,"add.s32 %r31, %r30, %r29;",20,861,0,881,0.005472,0.977299
stencil_1d,84,"ld.shared.u32 %r32, [%r3+36];",7,891,0,898,0.005578,0.992205
stencil_1d,85,"add.s32 %r33, %r32, %r31;",14,6,0,20,0.000124,0.300000
stencil_1d,86,"ld.shared.u32 %r34, [%r3+40];",336,62,0,398,0.002472,0.155779
stencil_1d,87,"add.s32 %r35, %r34, %r33;",294,60,0,354,0.002199,0.169492
stencil_1d,88,"ld.shared.u32 %r36, [%r3+44];",240,80,0,320,0.001988,0.250000
stencil_1d,89,"add.s32 %r37, %r36, %r35;",166,64,0,230,0.001429,0.278261
stencil_1d,90,"ld.shared.u32 %r38, [%r3+48];",199,76,0,275,0.001708,0.276364
stencil_1d,91,"add.s32 %r39, %r38, %r37;",120,68,0,188,0.001168,0.361702
stencil_1d,92,"ld.shared.u32 %r40, [%r3+52];",109,74,0,183,0.001137,0.404372
stencil_1d,93,"add.s32 %r41, %r40, %r39;",45,74,0,119,0.000739,0.621849
stencil_1d,94,"ld.shared.u32 %r42, [%r3+56];",43,74,0,117,0.000727,0.632479
stencil_1d,95,"add.s32 %r43, %r42, %r41;",10,37,0,47,0.000292,0.787234
stencil_1d,96,"add.s64 %rd8, %rd2, %rd6;",10,31,0,41,0.000255,0.756098
invalid_summary,,,69551,0,0,69551,0.431994,0.000000
