kernel,inst_line,inst_text,Masked,SDC,DUE,tot_inj,valid_rate,SDC_rate
stencil_1d,28,"ld.param.u64 %rd3, [_Z10stencil_1dPKiPii_param_0];",1923,434,0,2357,0.032736,0.184132
stencil_1d,29,"ld.param.u64 %rd4, [_Z10stencil_1dPKiPii_param_1];",1449,875,0,2324,0.032278,0.376506
stencil_1d,30,"ld.param.u32 %r6, [_Z10stencil_1dPKiPii_param_2];",2242,31,0,2273,0.031569,0.013638
stencil_1d,31,"mov.u32 %r7, %ntid.x;",2207,0,0,2207,0.030653,0.000000
stencil_1d,32,"mov.u32 %r8, %ctaid.x;",2286,13,0,2299,0.031931,0.005655
stencil_1d,33,"mov.u32 %r1, %tid.x;",1710,425,0,2135,0.029653,0.199063
stencil_1d,34,"mad.lo.s32 %r2, %r7, %r8, %r1;",1956,350,0,2306,0.032028,0.151778
stencil_1d,35,"setp.ge.s32%p1, %r2, %r6;",1386,0,0,1386,0.019250,0.000000
stencil_1d,38,"cvta.to.global.u64 %rd5, %rd3;",1464,8,0,1472,0.020444,0.005435
stencil_1d,39,"mul.wide.s32 %rd6, %r2, 4;",0,1750,0,1750,0.024306,1.000000
stencil_1d,40,"add.s64 %rd1, %rd5, %rd6;",1402,26,0,1428,0.019833,0.018207
stencil_1d,41,"ld.global.nc.u32 %r9, [%rd1];",1003,405,0,1408,0.019556,0.287642
stencil_1d,42,"shl.b32 %r10, %r1, 2;",1375,6,0,1381,0.019181,0.004345
stencil_1d,43,"mov.u32 %r11, _ZZ10stencil_1dPKiPiiE4temp;",1353,3,0,1356,0.018833,0.002212
stencil_1d,44,"add.s32 %r3, %r11, %r10;",43,1231,0,1274,0.017694,0.966248
stencil_1d,46,"setp.gt.u32%p2, %r1, 6;",1016,0,0,1016,0.014111,0.000000
stencil_1d,49,"setp.lt.s32%p3, %r2, 7;",26,0,0,26,0.000361,0.000000
stencil_1d,50,"mov.u32 %r44, 0;",33,1,0,34,0.000472,0.029412
stencil_1d,57,"add.s32 %r13, %r2, 249;",31,0,0,31,0.000431,0.000000
stencil_1d,58,"setp.ge.s32%p4, %r13, %r6;",26,0,0,26,0.000361,0.000000
stencil_1d,61,"ld.global.nc.u32 %r14, [%rd1+1024];",11,6,0,17,0.000236,0.352941
stencil_1d,65,"cvta.to.global.u64 %rd2, %rd4;",0,1225,0,1225,0.017014,1.000000
stencil_1d,67,"ld.shared.u32 %r15, [%r3+4];",636,395,0,1031,0.014319,0.383123
stencil_1d,68,"ld.shared.u32 %r16, [%r3];",632,365,0,997,0.013847,0.366098
stencil_1d,69,"add.s32 %r17, %r15, %r16;",578,30,0,608,0.008444,0.049342
stencil_1d,70,"ld.shared.u32 %r18, [%r3+8];",371,37,0,408,0.005667,0.090686
stencil_1d,71,"add.s32 %r19, %r18, %r17;",537,23,0,560,0.007778,0.041071
stencil_1d,72,"ld.shared.u32 %r20, [%r3+12];",694,37,0,731,0.010153,0.050616
stencil_1d,73,"add.s32 %r21, %r20, %r19;",651,36,0,687,0.009542,0.052402
stencil_1d,74,"ld.shared.u32 %r22, [%r3+16];",319,25,0,344,0.004778,0.072674
stencil_1d,75,"add.s32 %r23, %r22, %r21;",560,45,0,605,0.008403,0.074380
stencil_1d,76,"ld.shared.u32 %r24, [%r3+20];",464,23,0,487,0.006764,0.047228
stencil_1d,77,"add.s32 %r25, %r24, %r23;",195,44,0,239,0.003319,0.184100
stencil_1d,78,"ld.shared.u32 %r26, [%r3+24];",418,22,0,440,0.006111,0.050000
stencil_1d,79,"add.s32 %r27, %r26, %r25;",417,25,0,442,0.006139,0.056561
stencil_1d,80,"ld.shared.u32 %r28, [%r3+28];",430,34,0,464,0.006444,0.073276
stencil_1d,81,"add.s32 %r29, %r28, %r27;",396,37,0,433,0.006014,0.085450
stencil_1d,82,"ld.shared.u32 %r30, [%r3+32];",412,29,0,441,0.006125,0.065760
stencil_1d,83,"add.s32 %r31, %r30, %r29;",5,407,0,412,0.005722,0.987864
stencil_1d,84,"ld.shared.u32 %r32, [%r3+36];",6,388,0,394,0.005472,0.984772
stencil_1d,85,"add.s32 %r33, %r32, %r31;",6,3,0,9,0.000125,0.333333
stencil_1d,86,"ld.shared.u32 %r34, [%r3+40];",170,33,0,203,0.002819,0.162562
stencil_1d,87,"add.s32 %r35, %r34, %r33;",136,30,0,166,0.002306,0.180723
stencil_1d,88,"ld.shared.u32 %r36, [%r3+44];",121,39,0,160,0.002222,0.243750
stencil_1d,89,"add.s32 %r37, %r36, %r35;",82,35,0,117,0.001625,0.299145
stencil_1d,90,"ld.shared.u32 %r38, [%r3+48];",96,26,0,122,0.001694,0.213115
stencil_1d,91,"add.s32 %r39, %r38, %r37;",60,33,0,93,0.001292,0.354839
stencil_1d,92,"ld.shared.u32 %r40, [%r3+52];",54,26,0,80,0.001111,0.325000
stencil_1d,93,"add.s32 %r41, %r40, %r39;",23,34,0,57,0.000792,0.596491
stencil_1d,94,"ld.shared.u32 %r42, [%r3+56];",18,19,0,37,0.000514,0.513514
stencil_1d,95,"add.s32 %r43, %r42, %r41;",3,15,0,18,0.000250,0.833333
stencil_1d,96,"add.s64 %rd8, %rd2, %rd6;",2,17,0,19,0.000264,0.894737
invalid_summary,,,31465,0,0,31465,0.437014,0.000000
