kernel,inst_line,inst_text,Masked,SDC,DUE,tot_inj,valid_rate,SDC_rate
stencil_1d,28,"ld.param.u64 %rd3, [_Z10stencil_1dPKiPii_param_0];",1477,153,0,1630,0.032600,0.093865
stencil_1d,29,"ld.param.u64 %rd4, [_Z10stencil_1dPKiPii_param_1];",1005,626,0,1631,0.032620,0.383814
stencil_1d,30,"ld.param.u32 %r6, [_Z10stencil_1dPKiPii_param_2];",1633,7,0,1640,0.032800,0.004268
stencil_1d,31,"mov.u32 %r7, %ntid.x;",1553,0,0,1553,0.031060,0.000000
stencil_1d,32,"mov.u32 %r8, %ctaid.x;",1527,5,0,1532,0.030640,0.003264
stencil_1d,33,"mov.u32 %r1, %tid.x;",1154,275,0,1429,0.028580,0.192442
stencil_1d,34,"mad.lo.s32 %r2, %r7, %r8, %r1;",1304,266,0,1570,0.031400,0.169427
stencil_1d,35,"setp.ge.s32%p1, %r2, %r6;",986,0,0,986,0.019720,0.000000
stencil_1d,38,"cvta.to.global.u64 %rd5, %rd3;",1100,4,0,1104,0.022080,0.003623
stencil_1d,39,"mul.wide.s32 %rd6, %r2, 4;",0,1116,0,1116,0.022320,1.000000
stencil_1d,40,"add.s64 %rd1, %rd5, %rd6;",1017,14,0,1031,0.020620,0.013579
stencil_1d,41,"ld.global.nc.u32 %r9, [%rd1];",729,269,0,998,0.019960,0.269539
stencil_1d,42,"shl.b32 %r10, %r1, 2;",965,7,0,972,0.019440,0.007202
stencil_1d,43,"mov.u32 %r11, _ZZ10stencil_1dPKiPiiE4temp;",955,2,0,957,0.019140,0.002090
stencil_1d,44,"add.s32 %r3, %r11, %r10;",75,844,0,919,0.018380,0.918390
stencil_1d,46,"setp.gt.u32%p2, %r1, 6;",720,0,0,720,0.014400,0.000000
stencil_1d,49,"setp.lt.s32%p3, %r2, 7;",19,0,0,19,0.000380,0.000000
stencil_1d,50,"mov.u32 %r44, 0;",37,0,0,37,0.000740,0.000000
stencil_1d,57,"add.s32 %r13, %r2, 249;",17,0,0,17,0.000340,0.000000
stencil_1d,58,"setp.ge.s32%p4, %r13, %r6;",17,0,0,17,0.000340,0.000000
stencil_1d,61,"ld.global.nc.u32 %r14, [%rd1+1024];",23,3,0,26,0.000520,0.115385
stencil_1d,65,"cvta.to.global.u64 %rd2, %rd4;",0,863,0,863,0.017260,1.000000
stencil_1d,67,"ld.shared.u32 %r15, [%r3+4];",465,274,0,739,0.014780,0.370771
stencil_1d,68,"ld.shared.u32 %r16, [%r3];",429,264,0,693,0.013860,0.380952
stencil_1d,69,"add.s32 %r17, %r15, %r16;",404,29,0,433,0.008660,0.066975
stencil_1d,70,"ld.shared.u32 %r18, [%r3+8];",232,13,0,245,0.004900,0.053061
stencil_1d,71,"add.s32 %r19, %r18, %r17;",358,24,0,382,0.007640,0.062827
stencil_1d,72,"ld.shared.u32 %r20, [%r3+12];",476,21,0,497,0.009940,0.042254
stencil_1d,73,"add.s32 %r21, %r20, %r19;",497,23,0,520,0.010400,0.044231
stencil_1d,74,"ld.shared.u32 %r22, [%r3+16];",208,20,0,228,0.004560,0.087719
stencil_1d,75,"add.s32 %r23, %r22, %r21;",394,16,0,410,0.008200,0.039024
stencil_1d,76,"ld.shared.u32 %r24, [%r3+20];",330,19,0,349,0.006980,0.054441
stencil_1d,77,"add.s32 %r25, %r24, %r23;",147,26,0,173,0.003460,0.150289
stencil_1d,78,"ld.shared.u32 %r26, [%r3+24];",326,22,0,348,0.006960,0.063218
stencil_1d,79,"add.s32 %r27, %r26, %r25;",294,30,0,324,0.006480,0.092593
stencil_1d,80,"ld.shared.u32 %r28, [%r3+28];",270,20,0,290,0.005800,0.068966
stencil_1d,81,"add.s32 %r29, %r28, %r27;",270,14,0,284,0.005680,0.049296
stencil_1d,82,"ld.shared.u32 %r30, [%r3+32];",258,18,0,276,0.005520,0.065217
stencil_1d,83,"add.s32 %r31, %r30, %r29;",7,257,0,264,0.005280,0.973485
stencil_1d,84,"ld.shared.u32 %r32, [%r3+36];",8,249,0,257,0.005140,0.968872
stencil_1d,85,"add.s32 %r33, %r32, %r31;",4,3,0,7,0.000140,0.428571
stencil_1d,86,"ld.shared.u32 %r34, [%r3+40];",103,23,0,126,0.002520,0.182540
stencil_1d,87,"add.s32 %r35, %r34, %r33;",86,32,0,118,0.002360,0.271186
stencil_1d,88,"ld.shared.u32 %r36, [%r3+44];",94,11,0,105,0.002100,0.104762
stencil_1d,89,"add.s32 %r37, %r36, %r35;",50,26,0,76,0.001520,0.342105
stencil_1d,90,"ld.shared.u32 %r38, [%r3+48];",51,21,0,72,0.001440,0.291667
stencil_1d,91,"add.s32 %r39, %r38, %r37;",32,20,0,52,0.001040,0.384615
stencil_1d,92,"ld.shared.u32 %r40, [%r3+52];",36,20,0,56,0.001120,0.357143
stencil_1d,93,"add.s32 %r41, %r40, %r39;",18,19,0,37,0.000740,0.513514
stencil_1d,94,"ld.shared.u32 %r42, [%r3+56];",12,21,0,33,0.000660,0.636364
stencil_1d,95,"add.s32 %r43, %r42, %r41;",1,9,0,10,0.000200,0.900000
stencil_1d,96,"add.s64 %rd8, %rd2, %rd6;",3,9,0,12,0.000240,0.750000
invalid_summary,,,21817,0,0,21817,0.436340,0.000000
