kernel,inst_line,inst_text,Masked,SDC,DUE,tot_inj,valid_rate,SDC_rate
stencil_1d,28,"ld.param.u64 %rd3, [_Z10stencil_1dPKiPii_param_0];",1460,290,0,1750,0.031818,0.165714
stencil_1d,29,"ld.param.u64 %rd4, [_Z10stencil_1dPKiPii_param_1];",1130,682,0,1812,0.032945,0.376380
stencil_1d,30,"ld.param.u32 %r6, [_Z10stencil_1dPKiPii_param_2];",1717,22,0,1739,0.031618,0.012651
stencil_1d,31,"mov.u32 %r7, %ntid.x;",1663,0,0,1663,0.030236,0.000000
stencil_1d,32,"mov.u32 %r8, %ctaid.x;",1729,4,0,1733,0.031509,0.002308
stencil_1d,33,"mov.u32 %r1, %tid.x;",1284,318,0,1602,0.029127,0.198502
stencil_1d,34,"mad.lo.s32 %r2, %r7, %r8, %r1;",1455,324,0,1779,0.032345,0.182125
stencil_1d,35,"setp.ge.s32%p1, %r2, %r6;",1057,0,0,1057,0.019218,0.000000
stencil_1d,38,"cvta.to.global.u64 %rd5, %rd3;",1208,4,0,1212,0.022036,0.003300
stencil_1d,39,"mul.wide.s32 %rd6, %r2, 4;",0,1358,0,1358,0.024691,1.000000
stencil_1d,40,"add.s64 %rd1, %rd5, %rd6;",1124,21,0,1145,0.020818,0.018341
stencil_1d,41,"ld.global.nc.u32 %r9, [%rd1];",758,290,0,1048,0.019055,0.276718
stencil_1d,42,"shl.b32 %r10, %r1, 2;",1034,4,0,1038,0.018873,0.003854
stencil_1d,43,"mov.u32 %r11, _ZZ10stencil_1dPKiPiiE4temp;",1019,8,0,1027,0.018673,0.007790
stencil_1d,44,"add.s32 %r3, %r11, %r10;",70,1000,0,1070,0.019455,0.934579
stencil_1d,46,"setp.gt.u32%p2, %r1, 6;",767,0,0,767,0.013945,0.000000
stencil_1d,49,"setp.lt.s32%p3, %r2, 7;",24,0,0,24,0.000436,0.000000
stencil_1d,50,"mov.u32 %r44, 0;",33,1,0,34,0.000618,0.029412
stencil_1d,57,"add.s32 %r13, %r2, 249;",21,0,0,21,0.000382,0.000000
stencil_1d,58,"setp.ge.s32%p4, %r13, %r6;",12,0,0,12,0.000218,0.000000
stencil_1d,61,"ld.global.nc.u32 %r14, [%rd1+1024];",16,6,0,22,0.000400,0.272727
stencil_1d,65,"cvta.to.global.u64 %rd2, %rd4;",0,1001,0,1001,0.018200,1.000000
stencil_1d,67,"ld.shared.u32 %r15, [%r3+4];",449,292,0,741,0.013473,0.394062
stencil_1d,68,"ld.shared.u32 %r16, [%r3];",468,298,0,766,0.013927,0.389034
stencil_1d,69,"add.s32 %r17, %r15, %r16;",471,27,0,498,0.009055,0.054217
stencil_1d,70,"ld.shared.u32 %r18, [%r3+8];",272,32,0,304,0.005527,0.105263
stencil_1d,71,"add.s32 %r19, %r18, %r17;",416,23,0,439,0.007982,0.052392
stencil_1d,72,"ld.shared.u32 %r20, [%r3+12];",529,21,0,550,0.010000,0.038182
stencil_1d,73,"add.s32 %r21, %r20, %r19;",545,30,0,575,0.010455,0.052174
stencil_1d,74,"ld.shared.u32 %r22, [%r3+16];",258,26,0,284,0.005164,0.091549
stencil_1d,75,"add.s32 %r23, %r22, %r21;",429,30,0,459,0.008345,0.065359
stencil_1d,76,"ld.shared.u32 %r24, [%r3+20];",351,21,0,372,0.006764,0.056452
stencil_1d,77,"add.s32 %r25, %r24, %r23;",142,26,0,168,0.003055,0.154762
stencil_1d,78,"ld.shared.u32 %r26, [%r3+24];",332,13,0,345,0.006273,0.037681
stencil_1d,79,"add.s32 %r27, %r26, %r25;",292,27,0,319,0.005800,0.084639
stencil_1d,80,"ld.shared.u32 %r28, [%r3+28];",281,25,0,306,0.005564,0.081699
stencil_1d,81,"add.s32 %r29, %r28, %r27;",308,29,0,337,0.006127,0.086053
stencil_1d,82,"ld.shared.u32 %r30, [%r3+32];",271,27,0,298,0.005418,0.090604
stencil_1d,83,"add.s32 %r31, %r30, %r29;",5,328,0,333,0.006055,0.984985
stencil_1d,84,"ld.shared.u32 %r32, [%r3+36];",5,321,0,326,0.005927,0.984663
stencil_1d,85,"add.s32 %r33, %r32, %r31;",6,1,0,7,0.000127,0.142857
stencil_1d,86,"ld.shared.u32 %r34, [%r3+40];",114,33,0,147,0.002673,0.224490
stencil_1d,87,"add.s32 %r35, %r34, %r33;",103,21,0,124,0.002255,0.169355
stencil_1d,88,"ld.shared.u32 %r36, [%r3+44];",101,34,0,135,0.002455,0.251852
stencil_1d,89,"add.s32 %r37, %r36, %r35;",57,22,0,79,0.001436,0.278481
stencil_1d,90,"ld.shared.u32 %r38, [%r3+48];",72,16,0,88,0.001600,0.181818
stencil_1d,91,"add.s32 %r39, %r38, %r37;",29,26,0,55,0.001000,0.472727
stencil_1d,92,"ld.shared.u32 %r40, [%r3+52];",39,20,0,59,0.001073,0.338983
stencil_1d,93,"add.s32 %r41, %r40, %r39;",8,19,0,27,0.000491,0.703704
stencil_1d,94,"ld.shared.u32 %r42, [%r3+56];",16,32,0,48,0.000873,0.666667
stencil_1d,95,"add.s32 %r43, %r42, %r41;",3,16,0,19,0.000345,0.842105
stencil_1d,96,"add.s64 %rd8, %rd2, %rd6;",5,18,0,23,0.000418,0.782609
invalid_summary,,,23855,0,0,23855,0.433727,0.000000
